A Classroom with Desks
16
10
################################
##___=_______+__________=_vFcF##
##__Dh##Dh##Dh##______________##
##__Dv________________________##
##_+##________________________41
##__Dv_=_=____________________41
##__##_____________________+__##
##_________=__________________##
##____________________________##
######4040######################