A room with desks
12
14
########################
##_+__________________##
##____________________00
##__Dh##Dh##Dh##______00
##____________________##
##__Dh##Dh##Dh##______##
##____________________##
##__________________cR##
##____________________##
##___+_________=___=__##
##____________________##
##Dv________________Dv##
####_+__Dh##Dh##____####
########################