A Classroom with Desks
10
19
####################
##________________##
##________________##
##________________##
##________________##
##________________##
##________________##
##________________##
##________________##
##________________##
##________________##
43________________##
43________________##
##________________##
##________________##
##________________##
##________________##
##________________##
####################