A Classroom with Desks
10
14
####################
##________________##
##________________##
##________________##
##________________##
44________________##
44________________##
##________________##
##________________##
##________________##
##________________##
##________________##
##________________##
##########4545######