A Classroom with Desks
15
12
##############################
##__________________________##
##______Dv____Dv____Dv______##
##______##____##____##______##
##__________________________##
##______Dv____Dv____Dv______01
##______##____##____##______01
##__________________________##
##______Dv____Dv____________##
##______##____##______########
##____________________########
##############################