I don't know why these are labeled '101' etc, this is a one story building
10
14
####################
##___________+____##
##__Dh##Dh##Dh##__##
##________________##
##__Dh##Dh##Dh##__##
44________________##
44_____________+__##
##________________##
##________________##
##___=____________##
##_____________=__##
##___+____________##
##________________##
##########4545######