A Classroom with Desks
15
12
##############################
##cF________________________##
##______Dv____Dv____Dv______##
##______##____##____##______##
##_=_________________=______##
##______Dv____Dv____Dv______01
##______##____##____##_____=01
##___=______________________##
##______Dv____Dv_______=____##
##______##____##______########
##_________+__________########
##############################