A Classroom with Desks
16
10
################################
##____________________________##
##____________________________##
##____________________________##
##____________________________41
##____________________________41
##____________________________##
##____________________________##
##____________________________##
######4040######################