A room with desks
12
14
########################
##____________________##
##______________________
##__Dh##Dh##Dh##________
##____________________##
##__Dh##Dh##Dh##______##
##____________________##
##____________________##
##____________________##
##______PP____PP______##
##____________________##
##Dv________________Dv##
####____Dh##Dh##____####
########################