A room with desks
12
14
########################
##____________________##
##_________________k__00
##__Dh##Dh##Dh##______00
##____________________##
##__Dh##Dh##Dh##______##
##____________________##
##___t________________##
##____________________##
##_______________t_k__##
##____________________##
##Dv________________Dv##
####____Dh##Dh##____####
########################