A Classroom with Desks
10
19
####################
##________________##
##__Dh##Dh##Dh##__##
##________________##
##__Dh##Dh##Dh##__##
##________________##
##__Dh##Dh##Dh##__##
##________________##
##________________##
##_=______________##
##_____________=__##
43________________##
43___________+____##
##________________##
##___=____________##
##________________##
##________________##
##PB__PB________cB##
####################