A Classroom with Desks
15
14
########3939##################
##_____________+__cFcFvFcF__##
##___=______________________##
##__________________________##
##____Dh##__Dh##____________##
##__________________________##
##____Dh##__Dh##__Dh##______##
##__________________________##
##____Dh##_=Dh##__Dh##______02
##__________________________02
##___=______________________##
##_______+_______________=__##
##__________________________##
##############################