A Classroom with Desks
15
14
########8080##################
##____________________CF____##
##__________________________##
##__________________________##
##____Dh##__Dh##____________##
##__________________________##
##____Dh##__Dh##__Dh##______##
##__________________________##
##____Dh##__Dh##__Dh##______02
##__________________________02
##__________________________##
##__________________________##
##__________________________##
##############################