A room with desks
12
14
########################
##____________________##
##____________________00
##__Dh##Dh##Dh##______00
##____________________##
##__Dh##Dh##Dh##______##
##____________________##
##______CL____CR______##
##____________________##
##______CF____CB______##
##____________________##
##Dv________________Dv##
####____Dh##Dh##____####
########################