By all means, walk on the grass
20
26
########################################
##____________####2121####____________##
##___+_____________________________+__##
##____________________________________##
##____________________________________##
##____________________________________##
##____________________________________##
####_______________________+________####
####________________________________####
##20______________####______________22##
##20______________####______________22##
####_______________+________________####
####________________________________####
##____________________________________##
##____________________________________##
##____________________________________##
##____________________________________##
##____________________________________##
##____________________________________##
##____________________________________24
##___________+________________________24
##____________________________________##
##____________________________________##
##___+_____________________________+__##
##____________####2323####____________##
########################################