An Open, Central Courtyard
20
26
########################################
##____________####2121####____________##
##____________________________________##
##____________________________________##
##____________________________________##
##____________________________________##
##____________________________________##
####________________________________####
####________________________________####
##20______________####______________22##
##20______________####______________22##
####________________________________####
####________________________________####
##____________________________________##
##____________________________________##
##____________________________________##
##____________________________________##
##____________________________________##
##____________________________________##
##____________________________________24
##____________________________________24
##____________________________________##
##____________________________________##
##____________________________________##
##____________####2323####____________##
########################################