A Shed attached to the Courtyard
11
11
######################
##__________________##
##__________________##
##__________________##
24__________________##
24__________________##
##__________________##
##__________________##
##__________________##
##__________________##
######################