A Shed attached to the Courtyard
11
11
######################
##cFcFcF_=_=_______=##
##_______________=__##
##___=______________##
24_________=_____=__##
24___=______________##
##_=_________=_=____##
##_____________=____##
##___=______________##
##_=___________=cBvB##
######################