Full of many, many identical bookshelves
16
12
################################
##cF________________=_______cR##
##__________________________cR##
##_=___=____________________vR##
##_______________=____________##
##_____________________=_____+##
42_______________=_______=____##
42________________________cBcB##
##_+________####################
##__________####################
##__________####################
################################
