One does not simply walk into the multipurpose room
18
8
########6767##############4545######
##_____=___________+___=_______=__##
##________________________________##
##______Dh##____Dh##____________PR##
##___+_______________=____________##
##_________=____________________cR##
##_=_________________+__________cR##
####################################
