Bookings by appointment only
18
8
########4646##############4545######
##_____=___________+___=_______=__##
##________________________________##
##______Dh##____Dh##____________PR##
##___+_______________=____________##
##_________=____________________cR##
##_=_________________+__________cR##
####################################
