The North-Eastern Hallway
19
27
################____##################
####____________________##############
####____________________##############
##12____________________##############
##12____________________##############
####____________________##############
####______________________############
####______________________############
####____________________##############
####____________________##############
####____________________##############
####____________________##############
####________________________________##
####________________________________##
####______PP______PP________________##
##__________________________________##
____________________________________##
____________________________________##
##________PP______PP________________##
####__________________________________
####__________________________________
####________________________________##
########################____________##
########################____________##
########################____________##
########################____________##
############################1313######
