The North-Eastern Hallway
19
27
################4040##################
####_+__________________##############
####____________________##############
##12__________________cR##############
##12__________________cR##############
####____________________##############
####____________________42############
####____________________42############
####cL_____+____________##############
####____________________##############
####____________________##############
####___________________+##############
####______________________________cF##
####________________________________##
####______PP______PP________________##
##__________________________________##
22__________________________________##
22_________________+________________##
##________PP______PP________________##
####________________________________43
####________________________________43
####_+___________________________+__##
########################____________##
########################____________##
########################____________##
########################____________##
############################1313######
