The North-Eastern Hallway
19
27
################4040##################
####____________________##############
####____________________##############
##12____________________##############
##12____________________##############
####____________________##############
####____________________42############
####____________________42############
####____________________##############
####____________________##############
####____________________##############
####____________________##############
####________________________________##
####________________________________##
####______PP______PP________________##
##__________________________________##
22__________________________________##
22__________________________________##
##________PP______PP________________##
####________________________________43
####________________________________43
####________________________________##
########################____________##
########################____________##
########################____________##
########################____________##
############################1313######
