The North-Western Hallway
32
17
##########################################6666##################
################################cF____________________cF########
################################________________________########
########8181####################________________________########
##cFcF________________________________PP________PP__________cR##
##____________________________________________________________##
##____________________________________________________________12
##____________________________________________________________12
##_______________________+____________________________________##
##______PP______PP________cB__________________________________##
##______________________################________################
02______________________##################2121##################
02______________________########################################
##______PP______PP______########################################
##______________________########################################
##cBcB________________cB########################################
############1111################################################