The North-Western Hallway
32
17
##########################################6666##################
################################________________________########
################################________________________########
########8181####################________________________########
##____________________________________PP________PP____________##
##____________________________________________________________##
##____________________________________________________________12
##____________________________________________________________12
##____________________________________________________________##
##______PP______PP____________________________________________##
##______________________################________################
02______________________##################2121##################
02______________________########################################
##______PP______PP______########################################
##______________________########################################
##______________________########################################
############1111################################################