The North-Western Hallway
32
17
##########################################____##################
################################________________________########
################################________________________########
########____####################________________________########
##____________________________________PP________PP____________##
##____________________________________________________________##
##____________________________________________________________12
##____________________________________________________________12
##____________________________________________________________##
##______PP______PP____________________________________________##
##______________________################________################
________________________##################2121##################
________________________########################################
##______PP______PP______########################################
##______________________########################################
##______________________########################################
############1111################################################