A Central Hallway
32
17
##########################################____##################
################################________________________########
################################________________________########
########____####################________________________########
##____________________________________PP________PP____________##
##____________________________________________________________##
##______________________________________________________________
##______________________________________________________________
##____________________________________________________________##
##______PP______PP____________________________________________##
##______________________################________################
________________________##################____##################
________________________########################################
##______PP______PP______########################################
##______________________########################################
##______________________########################################
############1111################################################