Northwest is best, aparently...
32
17
##########################################6666##################
################################cF____________________cF########
################################________________________########
########3838####################________________________########
##cFcF_________+_______________+______PP________PP_______+__cR##
##____________________________________________________________##
##____________________________________________________________12
##____________________________________________________________12
##_______________________+____________________________________##
##______PP______PP________cB__________________________________##
##______________________################________################
02______________________##################2121##################
02_________+____________########################################
##______PP______PP______########################################
##______________________########################################
##cBcB________________cB########################################
############1111################################################