Just another room
23
10
##############################################
##__________________________________________##
##__________Dh##____Dh##____Dh##_=__________##
##___+______________________________________##
##__________Dh##____Dh##____Dh##_________=__##
##___=______________________________________##
##_________________________=___=____________##
##_____________________________________=____##
##_____________=____________________________##
########3939########################3838######