A Miscellaneous Room
8
10
################
##cFvFcFcFcFcF##
##____________##
##____________##
41____________##
41__Dh##Dh##__##
##____________##
##___=________##
##___________=##
################