A Miscellaneous Room
18
8
########4646##############4545######
##________________________________##
##________________________________##
##________________________________##
##________________________________##
##________________________________##
##________________________________##
####################################
