A Miscellaneous Room
8
10
################
##____________##
##____________##
##____________##
41____________##
41____________##
##____________##
##____________##
##____________##
################