A Miscellaneous Room
16
12
################################
##____________________________##
##____________________________##
##____________________________##
##____________________________##
##____________________________##
42____________________________##
42____________________________##
##__________####################
##__________####################
##__________####################
################################
