A Miscellaneous Room
18
8
########4646##############4545######
##_____=_______________=_______=__##
##________________________________##
##______Dh##____Dh##____________PR##
##___________________=____________##
##_________=____________________cR##
##_=_________________+__________cR##
####################################
