The South-Eastern Hallway
41
14
################################################################1313##############
############################################################____________________##
############################################################____________________##
############################################################____________________##
############################################################__________PP________##
##################2323######################################____________________44
################________####################################____________________44
##______________________________________________________________________________##
##______________________________________________________________________________##
14____________________________________________________________________PP________##
14______________________________________________________________________________##
##______________________________________________________________________________##
##______________________________________________________________________________##
########################################################################4646######