The Grand and Suspiciously Inoperable Entrance
28
15
########################################################
##____________________________________________________##
##____________________________________________________##
##____________________________________________________##
##________PP________________________________PP________##
##____________________________________________________##
##____________________________________________________##
##____________________________________________________##
##________PP________________________________PP________##
##____________________________________________________##
##____________________________________________________##
##____________############3030############____________##
##____________############################____________##
##____________############################____________##
########################################################