Who knows what's in here...
23
10
##############################################
##__________________________________________##
##__________________________________________##
##__________________________________________##
##__________________________________________##
##__________________________________________##
##__________________________________________##
##__________________________________________##
##__________________________________________##
########8080########################8181######